16,0,32,6,3,7,0,33,1,3,4,0,34,1,3,7,18
16,8,8,8,8,8,14,8,9,8,9,8,8,8,8,8,18
21,8,12,9,8,8,9,8,8,10,8,8,8,8,12,8,23
16,8,8,8,8,8,9,9,8,8,9,8,8,8,9,8,18
16,8,8,8,8,12,9,8,9,9,8,8,8,8,12,8,18
16,8,12,8,8,8,9,8,12,9,9,8,9,9,8,8,23
16,8,8,8,8,8,8,8,8,8,8,8,8,8,8,8,18
16,3,0,4,5,7,7,0,25,26,0,0,4,5,0,3,18
